R 1048 960
NO ./textures/eagle.xpm
SO ./textures/wood.xpm
WE ./textures/greystone.xpm
EA ./textures/redbrick.xpm
S ./textures/barrel.xpm
F 0,255,0
C 255,0,255

11111111111111111111111
10202020000000002000001
10000200000000002000001
10000020011100002000001
1E050000030100002000001
10005000011100000200001
10000000000000000000001
11111111111111111111111
