R 1048 960
NO ./textures/eagle.xpm
SO ./textures/wood.xpm
WE ./textures/greystone.xpm
EA ./textures/redbrick.xpm
S ./textures/barrel.xpm
F 0,255,0
C 255,0,255

111111111111111111111111111111111
111111111111111111111111111111111
111111111111111111111111111111111
111111110000000000000000000111111
111111110000000200000000000111111
1111111100N0000200000000000111111
111111110000000200000000000111111
111111110000000200000000000111111
111111111111111111111111111111111
111111111111111111111111111111111
111111111111111111111111111111111
